00000000000000000000000000000000000000000
11022222222202222202222222022202220222220
02020000000200000202020002020202020200020
02220222022202222202022202020222020202220
00000202020002000002000202020000020002000
02222202222222022202020202220222220222220
02000000020000020202020200000200000200020
02220222022222220222020222022202220202220
00020202000000000000020002020002020002000
02220202020222220222020222020222020222220
02000202020200000202020200000200020200000
02222202022222222202220222220202220222220
00000002000200000202000000020202020200020
02222222020222220202222222220202020222020
02000000020000020000000200000202020002020
02222222022202222202220222220202020222020
00020002000200000200020000020002020002020
02022202022202222202220222022222020222020
02000202020002000002000202000000020200020
02022202020222220222022202022222020222020
02020002020000020200020002000002020002020
02220222022222220222220202220222022222020
00000200000000000000000200020202020000020
02222202220222220222020222020202022222020
02000002020202020202020002020002000000020
02220222020202022202222202222202022202220
00020200020200000000000200020202020202000
02220222022202222202222202220202020222020
02000002000002000002020000000202020000020
02222222022222020222020222222202220202220
00000200000200020200020202000200000202020
02222202222202022202220202022222220222020
02000002000002020200000002020200000200020
02222202222222220202222202020202222202020
00000200000000000202000202020002000202020
02222202222222220222022222020222220202220
02000002000200020000000000020200020000020
02222202220222020222022222220222022202220
02000000020002020202020000000002000202000
02222222220222022202022222222222022202223
00000000000000000000000000000000000000000
